%%%%%%%%%%%%
%  A       %
%      S   %
%    O     %
%          %
%%%%%%%%E%%%
