%%%E%%%%%%%%%%%%
%           %%%%
% % O       %%%%
% %     K     S%
% % K          %
% %%S        O %
% %%           %
% %    O      S%
% %          %%%
% %  %%%   %%%%%
%A%%%%%%%%%%%%%%
%%%%%%%%%%%%%%%%
